1111111111
1001000F01
1001000F01
1001011111
1001001011
1001000001
1101010011
1100010001
1101010001
1111111111