11111111111111
10000000000001
10000000000001
10000000000001
10000000000001
10000000000001
10000000000001
10000000000001
10000000000001
10000000000001
1000000000F001
1000000000F001
10000000000001
11111111111111