11111111
10000001
11111001
10000001
1000F001
1000F001
10000001
11111111