111111111111
100000000001
100000000001
100000000001
100000000001
111111100001
100000000001
100000000001
10F000000001
10F000000001
100000000001
111111111111