111111111111111111
100000000000000001
100000000000010001
100000100000000001
100000000000000001
100000000000000001
100000000000100001
100000000000000001
100000000000000001
100001000000000001
100000000000000001
100000000000000001
100000000000000001
100000000000000001
100000000000000001
100000000001110001
100000000000000001
111111111111111111