111111111111111111
100000000000000001
100000000000000001
111111111111100001
100000000000000001
100000000000000001
111100001111111111
100000000000000001
100000000000000001
111111111000000001
100000000000001111
100000000000000001
111111111111111101
100000000000000001
100F00000000000001
100F00000001110001
100000000000000001
111111111111111111