11x11111111111111111
10xx0000000000000001
1000x000000000000001
1000x000000000000001
10000x00000000000001
10000000000000000001
10000000000000000001
10000000000000000001
10000000x00000000001
10000000x00000000001
10000000000000000001
10000000000000000001
10000000000000000001
10000000000000000001
10000000000000000001
10000000000000000001
10000000000000000001
1000000000000x000001
10000000000000000001
111111111111111x1111